apple => alma
ball => top
cat => pişik
dog => it
egg => yumurta
frog => qurbağa
goat => keçi
hand => əl
ink => mürəkkəb
juice => meyvə suyu, meyvə şirəsi
kite => çərpələng, uçurtma
leaf => yarpaq
monkey => meymun
nose => burun
ocean => okean
parrot => papuyqay
queen => kraliça
rope => kəndir, xalat
sun => günəş
tap => kran (musluq)
umbrella => çətir, şəmsiyyə, zontik
violin => skripka
water => su
xylophone => Ksilofon (musiqi aləti)
yellow => sarı
zoo => zoopark, heyvanat baxçası
xxxxxxxxxxxxxxxxxxxxxxxxxxxxxxxxxxxxxxxxxxxxx
one => bir
two => iki
three => üç
four => dörd
five => beş
six => altı
seven => yeddi
eight => səkkiz
nine => doqquz
ten => on
eleven => on bir
twelve => on iki
thirteen => on üç
fourteen => on dörd
fiveteen => on beş
sixteen => on altı
seventeen => on yeddi
eighteen => on səkkiz
nineteen => on doqquz
twenty => iyirmi
thirty => otuz
forty => qırx
fifty => əlli
sixty => altmış
seventy => yetmiş
eighty => səksən
ninety => doğsan
hundred => yüz
xxxxxxxxxxxxxxxxxxxxxxxxxxxxxxxxxxxxxxxxxxxxx
i => mən
you => sən
he => o (k. c)
she => o (q. c)
it => o (o. c)
we => biz
you => siz
they => onlar
xxxxxxxxxxxxxxxxxxxxxxxxxxxxxxxxxxxxxxxxxxxxx
me => mənə, məni
you => sənə, səni
him => ona, onu (k. c)
her => ona, onu (q. c)
it => ona, onu (o. c)
us => bizə, bizi
you => sizə, sizi
them => onlara, onları
xxxxxxxxxxxxxxxxxxxxxxxxxxxxxxxxxxxxxxxxxxxxx
my => mənim
your => sənin
his => onun (k. c)
her => onun (q. c)
its => onun (o. c)
our => bizim
your => sizin
their => onların
xxxxxxxxxxxxxxxxxxxxxxxxxxxxxxxxxxxxxxxxxxxxx
mine => mənimki
yours => səninki
his => onunku (k. c)
hers => onunku (q. c)
its => onunku (o. c)
ours => bizimki
yous => sizinki
theirs => onlarınkı
xxxxxxxxxxxxxxxxxxxxxxxxxxxxxxxxxxxxxxxxxxxxx
myself => özüm [tək]
yourself => özün [tək]
himself => özü (k. c) [tək]
herself => özü (q. c) [tək]
itself => özü (o. c) [tək]
ourselves => özümüz [cəm]
yourselves => özünüz [cəm]
themselves => özləri [cəm]
xxxxxxxxxxxxxxxxxxxxxxxxxxxxxxxxxxxxxxxxxxxxx
oeach other => bir-birini
one another => bir-birimizə
each other's => bir-birinin
xxxxxxxxxxxxxxxxxxxxxxxxxxxxxxxxxxxxxxxxxxxxx
this => bu (işarə əvəzliyi - yaxın və tək olan cisim və ya insanı işarə etmək üçün istifadə olunur)
these => bunlar (işarə əvəzliyi - uzaqda və tək olan cisim və ya insanı işarə etmək üçün istifadə olunur)
that => o (işarə əvəzliyi - yaxın və cəm olan cisim və ya insanları işarə etmək üçün istifadə olunur)
those => onlar (işarə əvəzliyi - uzaqda və cəm olan cisim və ya insanları işarə etmək üçün istifadə olunur)
such => elə, belə
same => həmin, eyni
xxxxxxxxxxxxxxxxxxxxxxxxxxxxxxxxxxxxxxxxxxxxx
who => kim
what => nə
wich => hansı
whom => kiminlə
whose => kimin
xxxxxxxxxxxxxxxxxxxxxxxxxxxxxxxxxxxxxxxxxxxxx
neither => heç biri
none => heç biri
nobody => heç kim
xxxxxxxxxxxxxxxxxxxxxxxxxxxxxxxxxxxxxxxxxxxxx
some => bir neçə, bir az, bəzi, bir qədər, təxminən, hər hansı, bəziləri
somebody => kimsə, bir kəs
someone => kimsə, bir kəs
something => nə isə, birşey
any => bir neçə, bir az, hər hansı, heç, heç bir, istənilən
anything => nə isə, hər bir (nə varsa)
anybody => kimsə, hər kəs (istənilən adam)
anyone => heç kim
xxxxxxxxxxxxxxxxxxxxxxxxxxxxxxxxxxxxxxxxxxxxx
to be => olmaq
i want to be a doctor. => mən həkim olmaq istəyirəm.
to be or not to be. => Olmaq, ya olmamaq.
be yourself. => özün ol.
xxxxxxxxxxxxxxxxxxxxxxxxxxxxxxxxxxxxxxxxxxxxx
box => qutu
tree => ağac
sex => cins (kişi, qadın)
fire => yanğın, atəş və hücum mənasınsa
gender => cins (kişi, qadın)
then => daha sonra, sonra
teen => gənc
so so => belə belə
hello => salam
hi => salam
morning => sabah
morn => sabah
afternoon => günorta
after => sonra
night => gecə
xxxxxxxxxxxxxxxxxxxxxxxxxxxxxxxxxxxxxxxxxxxxx
good morning => sabahın xeyir
good afternoon => günortan xeyir
good evening => axşamın xeyir
good night => gecəniz xeyirə
good bye => sağol
see you => görüşərik
xxxxxxxxxxxxxxxxxxxxxxxxxxxxxxxxxxxxxxxxxxxxx
a => bir (qeyrimüəyyən artikl)
advice => məsləhət
after => sonra
all => bütün
an => bir (qeyrimüəyyən artikl)
and => və
are => var
at => -da, -də
azerbaijan => Azərbaycan
be => olmaq
beasts => heyvanlar
best => ən yaxşı
black => qara
book => kitab
books => kitablar
boy's => oğlanın
breakfast => səhər yeməyi
browns => qəhvəyilər
but => amma, lakin
called => adlanır, çağırılır
camel => dəvə
can => bacarmaq, edə bilmək
cap => papaq
chess => şahmat
child => uşaq
children => uşaqlar
city => şəhər
cold => soyuq
comes => gəlir
comfortable => rahat
compass => kompas
conference => konfrans
cream => qaymaq, krem
daughters => qızlar
day => gün
december => dekabr
deep => dərin
desert => səhra
did => etdi
difficult => çətin
dinner => nahar
do => etmək
doctor => həkim
dog => it
down => aşağı
earth => yer
east => şərq
easy => asan
eight => səkkiz
english => ingilis
every => hər
exams => imtahanlar
exercise => məşq
famous => məşhur
five => beş
flower => çiçək
for => üçün
four => dörd
friday => cümə
friend => dost
friends => dostlar
give => vermək
go => getmək
goes => gedir
good => yaxşı
great => əla
half => yarım
hans => Hans (ad)
has => var
have => var
he => o (kişi)
his => onun (kişi)
hobby => hobbi
homework => ev tapşırığı
house => ev
hundred => yüz
i => mən
ice => buz
in => içində, -da, -də
is => -dır, -dir, var
it => o
its => onun (cansız, heyvan)
jane => Ceyn (ad)
kindness => mehribanlıq
king => kral
know => bilmək
lake => göl
language => dil
large => böyük
last => son
lessons => dərslər
let => icazə vermək, qoymaq
let's (let us) => gəlin
light => işıq
like => bəyənmək
lion => aslan
literature => ədəbiyyat
looks => baxır
lovely => gözəl, xoş
man => kişi
may => bilər
me => mənə
mile => mil
minute => dəqiqə
month => ay
moon => ay (göy cismi)
morning => səhər
musician => musiqiçi
must => mütləq
my => mənim
next => növbəti
nice => gözəl, xoş
nineteen => on doqquz
ninety-five => doxsan beş
north => şimal
not => deyil
number => nömrə
o'clock => saat
of => -ın, -in, -un, -ün
office => ofis
old => köhnə, yaşlı
on => üzərində, -da, -də
one => bir
our => bizim
over => üzərində
passed => keçdi
pen => qələm
people => insanlar
person => şəxs
piano => pianino
play => oynamaq
playing => oynayır
poet => şair
points => nöqtələr, xal
polite => nəzakətli
poor => kasıb
problem => problem
put => qoymaq
quality => keyfiyyət
quite => olduqca
rainy => yağışlı
rather => olduqca, daha
red => qırmızı
rich => varlı
room => otaq
rule => qayda
salty => duzlu
season => fəsil
shall => -acaq, -əcək (gələcək zaman köməkçi feil)
she => o (qadın)
shelf => rəf
ship => gəmi
sick => xəstə
sky => səma
sleeping => yatır
snow => qar
soldiers => əsgərlər
son => oğul
soup => şorba
south => cənub
speak => danışmaq
spring => yaz (fəsil)
student => tələbə
such => belə
sun => günəş
sunday => bazar
supper => axşam yeməyi
table => masa, stol
task => tapşırıq
teacher => müəllim
teen => yeniyetmə
tennis => tennis
the => müəyyənlik artiklı (Azərbaycan dilində ekvivalenti yoxdur)
there => orada
thirty-first => otuz birinci
this => bu
to => -a, -ə
treats => davranır, müalicə edir
twelve => on iki
two => iki
up => yuxarı
upper => yuxarıdakı
us => bizi, bizə
village => kənd
violin => skripka
wait => gözləmək
walked => gəzdı, yeridi
ware => əmtəə, məmulat
warm => isti
was => idi
we => biz
week => həftə
well => yaxşı
west => qərb
what => nə
when => nə vaxt
white => ağ
who => kim
will => olacaq
winter => qış
woman => qadın
world => dünya
wounded => yaralı
year => il
you => sən, siz
young => gənc
xxxxxxxxxxxxxxxxxxxxxxxxxxxxxxxxxxxxxxxxxxxxx
how old are you ? => sənin necə yaşın var ?
where are you from ? => sən hardansan ?
where are you now ? => indi haradasan ?
i am at work. => mən işdəyəm.
i am on the roof. => mən damdayam.
how are you doing today ? => bugün necəsən ?
how are you feeling today => bu gün özünü necə hiss edirsən?
how can i help you ? => sənə necə kömək edəbilərəm ?
what are you doing now ? => indi nə edirsən ?
what is its gender ? => bunun cinsi nədir ?
what is name of this ? => bunun adı nədir ?
where do you go in the morning ? => sabah (sabah-sabah) hara gedirsən ?
where in the morning ? => səhər-səhər hara ?
tomorrow => səhər (səhəri gün)
the day after tomorrow => sabahsı gün
what is up ? => necə gedir
long time no see => uzun vaxtdır görmürəm
what does it mean ? => bunun mənası nədi ?
how to answer ? => necə cavab verərlər ?
xxxxxxxxxxxxxxxxxxxxxxxxxxxxxxxxxxxxxxxxxxxxx
one hundred => yüz
one hundred one => yüz bir
one hundred two => yüz iki
one hundred three => yüz üç
one hundred ten => yüz on
one hundred eleven => yüz on bir
one hundred twelve => yüz on iki
one hundred thirteen => yüz on üç
one hundred fourteen => yüz on dörd
one hundred twenty => yüz iyirmi
one hundred twenty-one => yüz iyirmi bir
one hundred twenty-two => yüz iyirmi iki
one hundred thirty => yüz otuz
one hundred forty => yüz qırx
one hundred fifty => yüz əlli
two hundred => iki yüz
three hundred => üç yüz
four hundred => dörd yüz
five hundred => beş yüz
six hundred => altı yüz
seven hundred => yeddi yüz
eight hundred => səkkiz yüz
nine hundred => doqquz yüz
one thousand => min
one thousand one => min bir
one thousand two => min iki
one thousand three => min üç
one thousand four => min dörd
one thousand ten => min on
one thousand eleven => min on bir
one thousand twelve => min on iki
one thousand thirteen => min on üç
one thousand one hundred => min yüz
one thousand one hundred one => min yüz bir
one thousand one hundred two => min yüz iki
one thousand one hundred three => min yüz üç
one thousand one hundred four => min yüz dörd
one thousand one hundred five => min yüz beş
one thousand one hundred eleven => min yüz on bir
one thousand one hundred twelve => min yüz on iki
one thousand one hundred thirteen => min yüz on üç
one thousand one hundred fourteen => min yüz on dörd
one thousand one hundred fifteen => min yüz on beş
one thousand one hundred twenty => min yüz iyirmi
one thousand two hundred => min iki yüz
one thousand two hundred twenty-two => min iki yüz iyirmi iki
one thousand two hundred twenty-five => min iki yüz iyirmi beş
